                         
bbbbbbbbbbbbbbbbbbbbbbbbb
b                       b
b                       b
b     p            p    b
b    ppp          ppp   b
b     p            p    b
b                       b
b                       b
b           a           b
b                       b
b                       b
b                       b
b     p            p    b
b    ppp          ppp   b
b     p            p    b
b                       b
b                       b
bbbbbbbbbbbbbbbbbbbbbbbbb
